Segmentor	KEYWORD1
int	KEYWORD1
OUTPUT	KEYWORD1

one	KEYWORD2
two	KEYWORD2
three	KEYWORD2
four	KEYWORD2
five	KEYWORD2
six	KEYWORD2
seven	KEYWORD2
eight	KEYWORD2
nine	KEYWORD2
zero	KEYWORD2
chooseNumber	KEYWORD2
displayOne	KEYWORD2
displayTwo	KEYWORD2
displayThree	KEYWORD2
displayFour	KEYWORD2

value	LITERAL1
pinA	LITERAL1
pinB	LITERAL1
pinC	LITERAL1
pinD	LITERAL1
pinE	LITERAL1
pinF	LITERAL1
pinG	LITERAL1  
